非凡	Beyonder
魔药	potion
高序列强者	High-Sequence Beyonder
克莱恩	Klein
贝克兰德	Backlund
尼尔	Neil
阿兹克	Azik
封印物	Sealed Artifact
值夜者	Nighthawk
代罚者	Mandated Punisher
机械之心	Machinery Hivemind
班森	Benson
梅丽莎	Melissa
死灵导师	Spirit Guide
通灵者	Spirit Medium
戴莉	Daly
胡德·欧根	Hood Eugen
心灵世界	Mind World
仪式魔法	ritualistic magic
通灵术	mediumship ritual
廷根	Tingen
心理医生	Psychiatrist
梦魔	Nightmare
观众	Spectator
途径	Pathway
心理炼金会	Psychology Alchemists
兰尔乌斯	Lanevus
偷盗者	Marauder
真实造物者	True Creator
极光会	Aurora Order
西里斯	Sirius
梅纳德	Maynard
雪伦夫人	Madam Sharon
约翰·梅纳德	John Maynard
弗莱	Frye
非凡者	Beyonder
神弃之地	Forsaken Land of the Gods
罗塞尔	Roselle
罗塞尔大帝	Emperor Roselle
正义小姐	Miss Justice
海盗将军	Pirate Admiral
飓风中将	Vice Admiral Hurricane
齐林格斯	Qilangos
鲁恩	Loen
鲁恩语	Loenese
弗萨克	Feysac
弗萨克语	Feysac
古弗萨克语	Ancient Feysac
巨人语	Jotun
黑暗之民	People of the Dark
霍伊	Khoy
雪伦·霍伊	Sharon Khoy
新党	New Party
保守党	Conservative Party
黑荆棘	Blackthorn
木乃伊粉	mummy powder
特里斯	Tris
教唆者	Instigator
阳炎符咒	Flaring Sun Charm
魔女教派	Demoness Sect
小丑	Clown
原初魔女	Primordial Demoness
科恩黎	Kenley
查尼斯门	Chanis Gate
魔杖替身	Mirror Substitution
黑焰	Black Flame
邓恩·史密斯	Dunn Smith
科恩黎·怀特	Kenley White
吸血鬼	Vampire
异种	Mutant
伦纳德	Leonard
梅高欧丝	Megose
灵视	Spirit Vision
蒸汽与机械时代	Age of Steam and Machinery
洛耀	Royale
圣堂	Holy Cathedral
血管小偷	Blood Vessel Thief
变异的太阳圣徽	Mutated Sun Sacred Emblem
诗人	Poet
圣赛琳娜	Saint Selena
圣赛琳娜骨灰	Saint Selena's ashes
豪尔斯街	Howes Street
莫雷蒂	Moretti
佐特兰街	Zouteland Street
因斯·赞格威尔	Ince Zangwill
